3 1 2 4 5 8 7 6 9
7 8 5 1 6 9 3 2 4
4 9 6 2 7 3 8 5 1
1 3 4 5 2 6 9 7 8
2 5 7 8 9 1 6 4 3
9 6 8 3 4 7 5 1 2
5 2 9 6 3 4 1 8 7
8 4 3 7 1 5 2 9 6
6 7 1 9 8 2 4 3 5
