0 7 8 0 9 0 6 0 3
3 0 0 7 0 6 4 0 8
6 5 0 8 0 0 0 7 0
7 4 0 9 0 0 0 0 2
0 8 3 0 2 0 1 4 0
5 0 0 0 0 8 0 9 6
8 0 4 5 0 0 2 0 7
0 6 7 0 8 9 0 3 4
1 0 0 0 7 0 8 0 0
