4 7 8 2 9 1 6 5 3
3 1 9 7 5 6 4 2 8
6 5 2 8 3 4 9 7 1
7 4 6 9 1 5 3 8 2
9 8 3 6 2 7 1 4 5
5 2 1 3 4 8 7 9 6
8 9 4 5 6 3 2 1 7
2 6 7 1 8 9 5 3 4
1 3 5 4 7 2 8 6 9
